w从 r成 u它 o知	,
w亡 r官 u审 o夹	,,
w宣 r家 u䨈 o宇	,.
w宗 r万 u舱 o凃	,/
w寄 r艘 u畅 o站	,;
w立 r字 u骱 o乌	,a
w冯 r端 u申 o害	,b
w矢 r凝 u况 o宝	,c
w实 r额 u决 o客	,d
w盛 r寝 u宏 o净	,f
w舡 r艇 u安 o商	,g
w舰 r尹 u宴 o凉	,h
w宾 r冰 u虿 o舽	,j
w追 r章 u彰 o宫	,k
w短 r宿 u舟 o㝛	,l
w忘 r羽 u密 o甯	,m
w坐 r凌 u减 o船	,n
w帝 r旁 u翚 o凋	,p
w宁 r翼 u完 o寇	,q
w凛 r预 u宋 o般	,s
w察 r寡 u灾 o望	,t
w容 r骨 u富 o冷	,v
w智 r戳 u准 o室	,x
w宽 r矱 u凄 o冲	,y
w盗 r资 u次 o咨	,z
w力 r一 u死 o于	.
w臂 r溻 u趑 o趤	.,
w区 r劈 u虐 o超	..
w𫠡 r歼 u趁 o餐	./
w忽 r殊 u趋 o刎	.;
w趙 r駿 u虔 o殆	.a
w候 r豞 u赸 o正	.b
w殚 r貜 u赵 o璧	.c
w亾 r办 u虎 o再	.d
w混 r丙 u赴 o邴	.f
w走 r殛 u嬖 o兇	.g
w凶 r刀 u麪 o莫	.h
w倏 r武 u修 o麥	.j
w边 r互 u趥 o驅	.k
w残 r豕 u印 o駙	.l
w虑 r馬 u烈 o列	.m
w壁 r越 u叀 o豬	.n
w慕 r騙 u豟 o頸	.p
w温 r瓯 u画 o辟	.q
w觑 r虚 u檗 o段	.s
w习 r包 u灭 o丽	.t
w幕 r趣 u离 o政	.v
w驾 r贺 u架 o加	.x
w赶 r趨 u趟 o豹	.y
w忍 r虛 u欧 o起	.z
w个 r又 u第 o对	/
w众 r管 u瘳 o痴	/,
w劝 r病 u禽 o症	/.
w九 r费 u婴 o策	//
w奥 r笔 u贬 o贴	/;
w开 r箱 u瘤 o疤	/a
w笃 r笱 u笈 o寻	/b
w途 r斜 u算 o余	/c
w简 r鈦 u形 o赂	/d
w会 r戏 u笼 o贼	/f
w劲 r筑 u金 o疗	/g
w观 r赐 u癱 o疲	/h
w籍 r录 u疼 o剥	/j
w答 r千 u痛 o竹	/k
w贱 r熏 u卷 o创	/l
w型 r企 u瘀 o则	/m
w圣 r笛 u箴 o等	/n
w艰 r篇 u桑 o叠	/p
w簪 r笑 u弗 o全	/q
w鳥 r舒 u杂 o疫	/s
w鸡 r筵 u灵 o刺	/t
w篮 r癬 u飞 o败	/v
w赎 r彧 u难 o向	/x
w竿 r箫 u购 o疯	/y
w示 r贝 u欢 o邓	/z
w大 r战 u么 o我	;
w族 r糘 u㰰 o郟	;,
w糟 r毛 u卺 o囸	;.
w奈 r粁 u圈 o占	;/
w因 r麟 u虱 o书	;;
w遊 r籽 u糁 o麝	;a
w精 r囙 u籼 o夺	;b
w旃 r舆 u麀 o国	;c
w买 r真 u刍 o顛	;d
w奇 r丸 u奔 o鹿	;f
w围 r朱 u巨 o与	;g
w觇 r系 u乙 o皱	;h
w夷 r百 u图 o奓	;j
w达 r固 u米 o糊	;k
w糇 r料 u圇 o圄	;l
w急 r氶 u圍 o刻	;m
w圆 r套 u𡚽 o奢	;n
w牵 r興 u乏 o旗	;p
w舅 r亥 u园 o失	;q
w粉 r睾 u困 o粗	;s
w施 r旋 u点 o丄	;t
w直 r孠 u司 o敢	;v
w鹌 r臼 u禹 o回	;x
w断 r乩 u升 o爽	;y
w粮 r承 u团 o邹	;z
w这 r子 u能 o东	a
w矣 r窗 u介 o钨	a,
w穷 r切 u醨 o锻	a.
w究 r变 u銮 o钗	a/
w象 r孩 u参 o铁	a;
w销 r酸 u亦 o钯	aa
w牟 r镀 u镰 o射	ab
w链 r锈 u锐 o巴	ac
w肖 r钛 u文 o穴	ad
w酝 r钠 u身 o针	af
w空 r窍 u镢 o允	ag
w错 r锡 u醒 o矛	ah
w弯 r相 u锋 o窝	aj
w迹 r窑 u躽 o锯	ak
w钱 r穿 u镭 o七	al
w想 r孤 u铴 o刘	am
w锤 r铀 u躲 o铅	an
w银 r醇 u钢 o镦	ap
w孟 r斋 u留 o铱	aq
w锄 r酵 u柔 o醉	as
w逊 r锁 u酰 o孙	at
w帘 r窟 u钳 o收	av
w窦 r钞 u锥 o台	ax
w突 r孔 u躺 o钟	ay
w锦 r铲 u钦 o配	az
w来 r学 u及 o应	b
w青 r序 u驼 o静	b,
w只 r物 u㛃 o韶	b.
w亲 r度 u骚 o庚	b/
w骑 r骇 u庵 o店	b;
w峭 r峻 u斐 o骀	ba
w慧 r驹 u毒 o寿	bb
w崭 r嶷 u库 o巍	bc
w崂 r㠓 u山 o寸	bd
w庇 r閻 u庞 o艳	bf
w岸 r庭 u牲 o竟	bg
w觉 r素 u關 o广	bh
w马 r废 u峰 o够	bj
w过 r牯 u牺 o門	bk
w新 r岈 u庥 o府	bl
w意 r牥 u庳 o验	bm
w庄 r举 u崴 o特	bn
w非 r骗 u岗 o制	bp
w崽 r骡 u廉 o表	bq
w音 r驻 u床 o岁	bs
w遮 r巀 u庶 o底	bt
w席 r骤 u丰 o岩	bv
w造 r韻 u驶 o告	bx
w庸 r句 u嶱 o康	by
w帮 r凯 u母 o兴	bz
w并 r科 u言 o和	c
w气 r疑 u氨 o辖	c,
w曾 r黎 u车 o馍	c.
w轻 r瓶 u氟 o饷	c/
w稳 r麻 u荡 o目	c;
w稍 r季 u私 o饴	ca
w积 r識 u辰 o辱	cb
w稀 r颖 u税 o魔	cc
w丫 r稻 u藩 o落	cd
w希 r鼎 u饶 o称	cf
w眦 r饭 u委 o魏	cg
w香 r瞬 u眄 o以	ch
w单 r氧 u弟 o移	cj
w连 r较 u辩 o薄	ck
w暂 r转 u范 o妾	cl
w轮 r秘 u辨 o利	cm
w睡 r叛 u穘 o玉	cn
w眼 r轰 u稿 o稠	cp
w盯 r辆 u兽 o轿	cq
w盼 r顷 u杀 o鬼	cs
w瞪 r瞳 u秋 o睽	ct
w丹 r辗 u辛 o数	cv
w总 r秒 u瞧 o程	cx
w透 r秀 u兄 o种	cy
w饰 r馔 u软 o乘	cz
w在 r门 u却 o问	d
w纵 r缩 u绅 o冉	d,
w解 r蒙 u蟹 o绍	d.
w经 r释 u缨 o噕	d/
w头 r继 u阉 o缭	d;
w乍 r存 u纠 o练	da
w织 r绩 u级 o绑	db
w阐 r绣 u阅 o冒	dc
w阖 r丝 u影 o缓	dd
w曰 r纳 u绕 o统	df
w红 r𬘩 u妥 o绊	dg
w间 r八 u缂 o结	dh
w去 r缅 u终 o绳	dj
w给 r缘 u夬 o营	dk
w线 r太 u缏 o𠔇	dl
w怎 r纺 u阔 o闺	dm
w茔 r釉 u缄 o绪	dn
w老 r编 u纲 o绸	dp
w盍 r翻 u细 o闰	dq
w纷 r须 u采 o组	ds
w莺 r缵 u荧 o纸	dt
w缆 r𮉪 u闻 o平	dv
w续 r纱 u维 o各	dx
w纯 r景 u绱 o约	dy
w角 r兮 u闭 o纪	dz
w有 r或 u更 o将	f
w育 r翁 u輈 o郁	f,
w动 r协 u毙 o龆	f.
w禁 r负 u軫 o餘	f/
w可 r卣 u龋 o麓	f;
w墼 r戈 u雄 o色	fa
w骞 r𱌮 u龙 o專	fb
w餅 r鼑 u謇 o魂	fc
w亇 r饞 u寒 o十	fd
w哥 r戕 u歌 o毕	ff
w左 r版 u危 o充	fg
w奘 r壮 u桌 o装	fh
w比 r羸 u蠃 o公	fj
w运 r片 u卜 o博	fk
w下 r贏 u輪 o龉	fl
w云 r齿 u牌 o划	fm
w塞 r内 u饒 o牆	fn
w献 r南 u卿 o食	fp
w血 r瓮 u車 o袭	fq
w奖 r颂 u寨 o梦	fs
w盔 r楚 u灰 o尔	ft
w布 r颅 u弊 o卢	fv
w惑 r餑 u草 o右	fx
w状 r林 u弃 o争	fy
w飾 r翘 u皆 o久	fz
w她 r好 u生 o如	g
w逃 r亚 u函 o兆	g,
w功 r跑 u嫣 o韧	g.
w妇 r反 u姊 o厕	g/
w此 r严 u距 o跌	g;
w韦 r廷 u丢 o始	ga
w妈 r踱 u姆 o蹦	gb
w蹭 r歷 u娠 o半	gc
w姥 r趴 u踩 o路	gd
w遁 r质 u跪 o盾	gf
w妓 r妹 u姓 o跳	gg
w晋 r厚 u蹀 o跋	gh
w重 r汞 u曷 o些	gj
w工 r姑 u踊 o蹲	gk
w践 r顾 u雁 o厨	gl
w恶 r厂 u婢 o娃	gm
w支 r未 u唐 o压	gn
w跟 r足 u乡 o妒	gp
w厅 r妖 u嫌 o娇	gq
w嬗 r项 u女 o姐	gs
w婚 r姗 u跣 o踯	gt
w媳 r蹑 u媒 o攻	gv
w恕 r妙 u躁 o娱	gx
w恐 r奶 u姬 o儿	gy
w娘 r巧 u歇 o妃	gz
w日 r最 u照 o人	h
w暄 r晟 u鞍 o散	h,
w勒 r易 u𭑵 o昭	h.
w旯 r受 u款 o晌	h/
w鞑 r晐 u幻 o壽	h;
w鞘 r晙 u鞣 o天	ha
w暗 r織 u煦 o时	hb
w晞 r夏 u革 o看	hc
w昨 r果 u丅 o暖	hd
w昆 r晚 u晓 o統	hf
w紅 r昧 u星 o京	hg
w拜 r曝 u畿 o爱	hh
w勤 r曦 u蚕 o夥	hj
w手 r綠 u昂 o暱	hk
w见 r曘 u鞭 o晤	hl
w志 r舜 u緯 o鞋	hm
w暇 r黄 u曉 o暑	hn
w映 r鼻 u晕 o暾	hp
w靴 r幺 u廿 o皮	hq
w晰 r显 u杲 o友	hs
w盟 r暴 u炅 o明	ht
w遇 r罄 u禺 o声	hv
w暹 r颉 u燕 o本	hx
w旱 r世 u鞠 o昀	hy
w鹫 r士 u晃 o就	hz
w里 r发 u处 o不	j
w遣 r野 u蛇 o弱	j,
w务 r丕 u螭 o歪	j.
w遗 r贵 u蜷 o蜍	j/
w美 r耗 u耒 o蛾	j;
w旦 r羧 u弘 o耙	ja
w逢 r夠 u蚌 o多	jb
w弹 r羲 u蜕 o着	jc
w引 r蠓 u冬 o蚺	jd
w虾 r蚋 u卡 o弥	jf
w式 r蜓 u姜 o呙	jg
w兵 r蜴 u蝶 o耩	jh
w量 r贰 u蜂 o蝇	jj
w还 r面 u蛹 o蝴	jk
w遺 r蠕 u𧒽 o蛴	jl
w忒 r弧 u虫 o蛙	jm
w逄 r疆 u蟛 o蟢	jn
w弓 r水 u螈 o黾	jp
w益 r螺 u备 o善	jq
w蜥 r弦 u条 o上	js
w弛 r叔 u羔 o用	jt
w螅 r蚙 u蝠 o张	jv
w犟 r䖢 u强 o否	jx
w螳 r羊 u蟒 o蠛	jy
w耕 r蝮 u蚁 o二	jz
w合 r交 u说 o认	k
w医 r诚 u谬 o谊	k,
w勇 r彖 u谑 o证	k.
w票 r译 u诊 o飘	k/
w谜 r该 u词 o讯	k;
w诮 r奂 u西 o谢	ka
w请 r胊 u曲 o讨	kb
w肉 r诱 u辜 o居	kc
w患 r典 u缺 o评	kd
w甫 r讷 u民 o计	kf
w缸 r兔 u要 o克	kg
w拿 r课 u谍 o谨	kh
w试 r详 u酋 o让	kj
w通 r谭 u诵 o谔	kk
w迎 r讶 u卸 o语	kl
w论 r访 u匯 o剧	km
w嘏 r早 u歅 o诸	kn
w训 r匾 u诨 o调	kp
w谓 r古 u谦 o吕	kq
w辶 r颌 u话 o设	ks
w鸽 r诞 u谈 o乐	kt
w谎 r诹 u谋 o故	kv
w读 r覆 u谁 o误	kx
w哭 r匶 u罐 o器	ky
w讲 r𰵞 u议 o许	kz
w他 r们 u使 o什	l
w位 r伊 u伸 o侠	l,
w霾 r卫 u岳 o例	l.
w雪 r仅 u佛 o侧	l/
w值 r斗 u亿 o俄	l;
w像 r专 u价 o佁	la
w件 r债 u仙 o付	lb
w僧 r倾 u信 o似	lc
w作 r俘 u條 o伻	ld
w何 r侦 u便 o齐	lf
w伟 r促 u任 o露	lg
w借 r仕 u偶 o体	lh
w但 r代 u佟 o仁	lj
w近 r估 u仰 o做	lk
w伍 r传 u倫 o霁	ll
w伦 r黑 u俾 o偷	lm
w假 r牙 u侖 o侍	ln
w停 r偏 u雨 o侬	lp
w五 r需 u雷 o依	lq
w份 r住 u休 o儇	ls
w鸦 r供 u伙 o低	lt
w俗 r倔 u伲 o零	lv
w堡 r㑺 u保 o倒	lx
w默 r仍 u倘 o仲	ly
w伤 r倍 u伯 o优	lz
w心 r方 u海 o没	m
w肯 r演 u卑 o俞	m,
w师 r末 u梁 o漠	m.
w临 r汉 u染 o测	m/
w渊 r必 u泛 o沾	m;
w消 r酒 u溜 o治	ma
w清 r渡 u汲 o剑	mb
w渐 r渺 u雌 o泪	mc
w法 r浮 u潘 o洛	md
w河 r淋 u浇 o汁	mf
w江 r瓜 u深 o派	mg
w添 r泄 u婆 o波	mh
w溢 r洋 u浊 o涨	mj
w漂 r汇 u涌 o湖	mk
w浅 r流 u鎏 o济	ml
w沦 r步 u淤 o洼	mm
w浙 r油 u澎 o沿	mn
w洲 r沉 u源 o沈	mp
w潜 r滋 u渔 o滚	mq
w液 r注 u活 o沮	ms
w池 r止 u淡 o港	mt
w帅 r潺 u泥 o放	mv
w渎 r沙 u命 o潮	mx
w汗 r满 u沟 o津	my
w浪 r泳 u泊 o激	mz
w地 r由 u场 o都	n
w拉 r城 u按 o搬	n,
w垂 r抱 u威 o招	n.
w扫 r择 u抢 o墙	n/
w扭 r搜 u扬 o托	n;
w控 r几 u击 o把	na
w排 r拘 u摧 o境	nb
w指 r攫 u振 o接	nc
w抓 r摇 u块 o援	nd
w批 r找 u扑 o撤	nf
w技 r挺 u探 o者	ng
w措 r授 u堞 o拔	nh
w担 r幸 u拤 o坏	nj
w捕 r换 u抑 o据	nk
w折 r报 u誓 o哲	nl
w抡 r扯 u掛 o挂	nm
w员 r抽 u垛 o持	nn
w土 r堪 u挥 o护	np
w打 r抚 u壤 o扶	nq
w摆 r抗 u括 o投	ns
w挡 r撞 u赫 o抵	nt
w感 r摄 u咸 o提	nv
w捐 r携 u推 o喜	nx
w塔 r扎 u描 o均	ny
w拖 r培 u拍 o扰	nz
w情 r双 u之 o其	p
w忙 r扇 u惋 o㤞	p,
w恼 r豪 u煭 o怔	p.
w怪 r贯 u怆 o恻	p/
w央 r毫 u忆 o写	p;
w悄 r享 u熟 o户	pa
w扉 r惴 u㧀 o忖	pb
w憎 r悸 u军 o刚	pc
w怯 r憬 u快 o恪	pd
w怖 r愤 u恢 o忪	pf
w鸩 r怓 u性 o亨	pg
w惜 r慢 u惺 o惊	ph
w怛 r群 u融 o怀	pj
w退 r冤 u恓 o愕	pk
w斯 r君 u即 o悟	pl
w愿 r房 u愇 o愉	pm
w基 r亮 u雕 o周	pn
w州 r惯 u慨 o忱	pp
w亭 r懒 u既 o农	pq
w懔 r顺 u毋 o悴	ps
w遍 r扁 u災 o期	pt
w川 r慑 u同 o怜	pv
w鹤 r悖 u高 o启	px
w懂 r甚 u惝 o网	py
w悢 r愎 u原 o忧	pz
w现 r出 u界 o前	q
w胃 r剪 u煎 o𱯄	q,
w势 r微 u璃 o畏	q.
w逆 r货 u珍 o朔	q/
w琦 r而 u束 o玷	q;
w現 r㺭 u玟 o斑	qa
w玛 r瑞 u璀 o衣	qb
w琏 r琇 u柬 o稣	qc
w衰 r瑶 u执 o略	qd
w毗 r赖 u元 o华	qf
w丁 r夭 u耍 o王	qg
w规 r累 u鲽 o玻	qh
w理 r鲜 u蛰 o兰	qj
w远 r鲛 u襄 o瑚	qk
w化 r两 u褒 o琊	ql
w思 r鲂 u瑋 o班	qm
w垫 r无 u瑊 o畤	qn
w珢 r瑙 u鲫 o琪	qp
w替 r琴 u玩 o琶	qq
w普 r顶 u鱼 o環	qs
w鸷 r珊 u热 o夫	qt
w鲶 r夔 u田 o整	qv
w琄 r㻪 u琟 o哀	qx
w瑛 r瓦 u弄 o球	qy
w琅 r鳆 u珀 o碧	qz
w分 r你 u外 o名	s
w棕 r棺 u桉 o卒	s,
w助 r柄 u㯊 o模	s.
w标 r权 u枪 o树	s/
w置 r核 u杨 o尺	s;
w柳 r李 u县 o教	sa
w罪 r枸 u极 o村	sb
w罾 r㰀 u载 o楼	sc
w罢 r具 u四 o格	sd
w柯 r森 u械 o松	sf
w枝 r板 u雍 o桃	sg
w棍 r横 u舌 o率	sh
w查 r样 u鼠 o杯	sj
w适 r校 u桶 o罚	sk
w夜 r主 u皙 o梧	sl
w您 r业 u另 o别	sm
w杜 r机 u椷 o署	sn
w根 r椁 u概 o夕	sp
w盆 r戴 u亩 o裁	sq
w逻 r柱 u木 o罗	ss
w档 r页 u杰 o棚	st
w市 r梶 u甜 o敌	sv
w椟 r枵 u截 o杏	sx
w杆 r乱 u构 o且	sy
w述 r考 u材 o术	sz
w也 r共 u然 o小	t
w六 r膀 u火 o熵	t,
w脑 r炮 u燦 o膜	t.
w当 r滕 u釜 o頁	t/
w烟 r舂 u肠 o氏	t;
w腔 r延 u关 o爸	ta
w脏 r朐 u岛 o肘	tb
w脂 r煫 u脱 o秦	tc
w炸 r童 u脚 o胳	td
w煥 r臣 u烧 o胪	tf
w肢 r烶 u胜 o胖	tg
w春 r爆 u蠢 o奏	th
w胆 r泰 u蛋 o爹	tj
w选 r胶 u腰 o膊	tk
w登 r服 u爷 o脐	tl
w父 r肪 u脾 o脸	tm
w尘 r奉 u膨 o月	tn
w腿 r煽 u先 o炉	tp
w灯 r册 u朊 o烂	tq
w腋 r烦 u枭 o股	ts
w鹏 r赞 u炎 o朋	tt
w鸟 r脲 u煤 o胀	tv
w焆 r脖 u雀 o肟	tx
w胸 r甩 u爟 o肿	ty
w胛 r脉 u炊 o郑	tz
w道 r题 u联 o是	v
w定 r磅 u碗 o硖	v,
w行 r卅 u屍 o㞘	v.
w研 r取 u鉴 o尉	v/
w自 r尾 u属 o局	v;
w聊 r砌 u首 o衔	va
w职 r碛 u碳 o矿	vb
w谷 r礙 u尼 o眉	vc
w确 r芒 u幡 o长	vd
w层 r帧 u硬 o磚	vf
w帏 r砺 u碣 o石	vg
w览 r紧 u甘 o破	vh
w犀 r尿 u屬 o碍	vj
w砸 r碘 u硒 o砾	vk
w所 r今 u邑 o衙	vl
w息 r舞 u碑 o街	vm
w坚 r展 u碱 o尸	vn
w带 r聂 u耳 o耽	vp
w监 r础 u麦 o副	vq
w碴 r硕 u某 o碎	vs
w臀 r幢 u耿 o殿	vt
w衡 r碾 u幅 o帐	vv
w屐 r履 u礁 o屋	vx
w臭 r帆 u砹 o事	vy
w屙 r领 u欲 o令	vz
w很 r少 u神 o到	x
w喧 r嘀 u呻 o呜	x,
w徒 r初 u唬 o征	x.
w径 r叹 u啥 o响	x/
w嗯 r咳 u电 o哦	x;
w勃 r彻 u叫 o吧	xa
w吗 r喘 u吸 o亏	xb
w禅 r嘛 u史 o至	xc
w卖 r叭 u衫 o呼	xd
w德 r喷 u补 o叶	xf
w嘴 r味 u喝 o循	xg
w视 r索 u喋 o被	xh
w哩 r祥 u虽 o得	xj
w哈 r咬 u御 o品	xk
w听 r呀 u叩 o咐	xl
w啃 r袜 u啤 o哇	xm
w社 r袖 u喊 o待	xn
w嘶 r裙 u唧 o口	xp
w叮 r咄 u嚷 o呈	xq
w吩 r往 u集 o祖	xs
w鸣 r哄 u焦 o朝	xt
w咱 r吟 u呢 o致	xv
w噎 r吵 u唯 o售	xx
w吨 r礼 u喵 o哪	xy
w啊 r号 u吃 o祁	xz
w常 r建 u节 o中	y
w蒂 r孽 u薛 o隶	y,
w匈 r苏 u葬 o茄	y.
w盈 r赏 u茶 o荆	y/
w茵 r飕 u艺 o菌	y;
w猛 r孕 u勾 o茅	ya
w莱 r狗 u警 o敬	yb
w莲 r鼐 u艾 o求	yc
w蕴 r荐 u菜 o药	yd
w尝 r芮 u卵 o若	yf
w董 r菇 u尚 o党	yg
w掌 r蔓 u猩 o萌	yh
w蓬 r苤 u独 o猕	yj
w狱 r苦 u茜 o葫	yk
w荷 r芽 u犯 o苻	yl
w忠 r肃 u菸 o刊	ym
w堂 r藏 u橥 o著	yn
w英 r乃 u芝 o芦	yp
w花 r敖 u苗 o狂	yq
w干 r顿 u蓄 o蔑	ys
w蔡 r藤 u狄 o风	yt
w蓝 r芩 u茸 o救	yv
w狷 r凡 u蕉 o爻	yx
w获 r萧 u猫 o飙	yy
w狼 r萨 u熙 o那	yz
w进 r三 u才 o为	z
w背 r障 u院 o陕	z,
w陡 r陋 u歓 o阷	z.
w际 r阡 u亷 o除	z/
w隐 r入 u乞 o皋	z;
w陗 r廹 u阶 o陈	za
w井 r繁 u每 o导	zb
w隧 r隊 u义 o北	zc
w阼 r颜 u彦 o皭	zd
w随 r陷 u陇 o午	zf
w尰 r皈 u光 o竞	zg
w阳 r复 u隅 o队	zh
w隘 r永 u隆 o降	zj
w迫 r皎 u隁 o己	zk
w斲 r产 u卮 o附	zl
w已 r防 u陴 o险	zm
w陨 r陵 u陆 o年	zn
w限 r隔 u辉 o朗	zp
w遑 r冀 u阮 o皇	zq
w䧒 r烏 u白 o阻	zs
w鸭 r䧆 u欠 o阴	zt
w甲 r陬 u兀 o改	zv
w逅 r丂 u陮 o后	zx
w卌 r陶 u异 o尥	zy
w阱 r陪 u阢 o部	zz
